1212111211
1000000001
2011010101
1000000002
2000000001
1000000001
1013000002
1000020111
1000010001
1111111111